|-------|
|@......|
|.......|
|.......|
|.......|
|.......|
|.......|
|.......|
|.......|
|-------|