|-----------------|
|@................|
|..........|......|
|..........|......|
|..........|__....|
|...|........|....|
|...___...........|
|.................|
|.................|
|-----------------|